46,11
1111111111111111111111111111111111111111111111
1000000000000000100000100000000000000000000001
1000111111111100100000100000000000000000000001
1001100000000100100000100000000000000000000001
1001000111100100000000100000000000000000000001
1000001100100111100111100000000000000000000001
1000011000100000000000000000000000000000000001
1000110000111111111111100000000000000000000001
1020100000000000000000100000000000000000000001
1000100000000000000000100000000000000000000001
1111111111111111111111111111111111111111111111